xxxxxxxxxxxxx    xxxxxxxxxxxxx
xx                          xx
x                            x
x                            x
x                            x
x                            x
x    xxx              xxx    x
x                            x
x                            x
x             xx             x
x                            x
x                            x
x                            x  
x                            x
                              
                              
x                            x
x                            x
x                            x
x                            x
x             xx             x
x                            x
x                            x
x    xxx              xxx    x
x                            x
x                            x
x                            x
x                            x
xx                          xx
xxxxxxxxxxxxx    xxxxxxxxxxxxx