xxxxxxxxxxxxx    xxxxxxxxxxxxx
x                            x
x                            x
x                            x
x                            x
x                            x
x                          xxx
x                          xxx
x                            x
x                            x
x                            x
x                            x
x                            x
                              
                              
                              
                              
x                            x
x                            x
x                            x
x                            x
x                            x
xxx                          x
xxx                          x
x                            x
x                            x
x                            x
x                            x
x                            x
xxxxxxxxxxxxx    xxxxxxxxxxxxx